12 9
X61 --- --- --- --- --- X61 --- --- --- --- X19
X18 ... ... ... Y21 --- ... ... ... b22 --- |||
||| ... ... ... ... ... ... ... ... ||| ||| |||
||| ... ... ... ... ... W11 ... ... ... ... |||
||| ... ... ... ... ... ... ... ... ... ... |||
||| X11 ... ... ... ... ... X11 ... ... ... |||
||| B22 --- ... ... ... ... R12 X32 --- --- |||
||| ||| ||| ... ... ... ... ||| ||| --- --- |||
X61 --- --- --- --- --- X61 --- --- --- --- ---


