7 7
X71 --- --- --- --- --- ---
X15 ... R11 ... ... ... X16
||| ... ... ... ... B11 |||
||| ... ... r11 ... ... |||
||| Y11 ... ... ... ... |||
||| ... ... ... R11 ... |||
X61 --- --- --- --- --- |||



