15
13 9
X61 --- --- --- --- --- X71 --- --- --- --- --- X19
X18 X12 ... ... X51 --- --- --- --- w11 r11 b11 |||
||| ||| ... ... X51 --- --- --- --- ... ... ... |||
||| p11 ... ... ... ... ... ... ... ... ... ... |||
||| X14 ... ... ... ... ... ... ... ... ... ... |||
||| ||| ... ... ... ... ... ... ... ... ... ... |||
||| ||| ... ... ... ... ... ... ... ... ... ... |||
||| ||| ... ... ... ... ... ... ... ... ... ... |||
X61 --- --- --- --- --- X71 --- --- --- --- --- ---


