25
7 7
X71 --- --- --- --- --- ---
X15 ... ... ... ... ... X16
||| ... ... ... ... ... |||
||| ... ... r11 ... ... |||
||| Y11 ... ... ... B11 |||
||| ... R11 ... R11 ... |||
X61 --- --- --- --- --- |||



