7
12 9
X61 --- --- --- --- --- X61 --- --- --- --- X19
X18 X23 --- ... ... ... X12 ... X12 Y11 ... |||
||| ||| ||| ... ... ... ||| ... ||| ... ... |||
||| ||| ||| ... ... ... X11 W12 ... ... ... |||
||| ... ... ... ... ... ... ||| ... ... o11 |||
||| ... ... ... ... ... X21 --- X31 --- --- |||
||| ... ... ... ... X62 --- --- --- --- --- |||
||| R11 ... ... X11 ||| --- --- --- --- --- |||
X61 --- --- --- --- --- X61 --- --- --- --- ---


