12 9
X61 --- --- --- --- --- X61 --- --- --- --- X19
X18 Y11 ... ... ... ... ... W14 ... ... ... |||
||| ... ... ... ... ... ... ||| ... ... ... |||
||| ... ... ... ... ... ... ||| ... ... ... |||
X71 --- --- --- --- --- --- ||| X21 --- ... |||
||| R11 ... ... ... ... ... ... ... ... ... |||
||| ... ... ... ... ... ... ... ... ... ... |||
||| ... ... ... ... ... ... ... o11 ... ... |||
X61 --- --- --- --- --- X61 --- --- --- --- ---


