12 9
X61 --- --- --- --- --- X61 --- --- --- --- X19
X18 W11 ... ... ... ... ... ... ... ... ... |||
||| ... ... ... ... ... ... ... ... ... ... |||
||| ... ... ... ... ... ... ... ... ... ... |||
||| ... ... ... ... ... ... ... ... ... ... |||
||| ... ... ... ... ... ... w11 ... ... ... |||
||| ... ... ... ... W32 --- --- X32 --- --- |||
||| ... ... ... ... ||| --- --- ||| --- --- |||
X61 --- --- --- --- --- X61 --- --- --- --- ---


