10 6
X91 --- --- --- --- --- --- --- --- X16
X15 r11 ... ... ... ... R11 ... ... |||
||| ... ... ... ... ... ... ... ... |||
||| ... ... R22 --- ... ... ... ... |||
||| ... ... ||| ||| Y31 --- --- ... |||
||| X81 --- --- --- --- --- --- --- |||


