12 9
X61 --- --- --- --- --- X61 --- --- --- --- X19
X18 B11 R11 X31 --- --- Y51 --- --- --- --- |||
||| r11 ... ... ... ... ... ... ... ... X16 |||
||| ... ... ... ... ... ... ... ... ... ||| |||
X71 ... ... ... ... ... ... ... ... ... ||| |||
||| ... ... ... Y23 --- ... ... ... ... ||| |||
||| ... ... ... ||| ||| ... ... ... ... ||| |||
||| ... ... ... ||| ||| ... ... ... ... ||| |||
X61 --- --- --- --- --- X61 --- --- --- --- ---


