10 6
X91 --- --- --- --- --- --- --- --- X16
X15 ... ... ... ... ... R11 ... ... |||
||| ... ... ... ... ... ... ... ... |||
||| ... ... R11 ... ... ... ... ... |||
||| ... ... ... ... ... ... ... ... |||
||| X81 --- --- --- --- --- --- --- |||


