7
8 6
X71 --- --- --- --- --- --- X16
X14 ... ... ... w11 ... ... |||
||| ... X23 --- ... X12 ... |||
||| ... ||| ||| ... ||| ... |||
||| W11 ||| ||| ... ... ... |||
X71 --- --- --- --- --- --- |||


